10
G.G.-.-.B.P.B.-.-.G
-.-.-.-.G.BS.-.-.-.-
-.G.-.-.S.W.S.-.-.-
G.B.-.-.-.S.-.-.-.-
B.P.B.-.-.-.-.A.-.-
-.B.P.B.-.-.-.-.-.-
-.-.B.-.S.-.-.B.-.-
G.S.-.SG.GW.S.B.P.B.-
S.W.S.-.S.-.-.B.-.-
G.S.-.-.-.-.-.-.-.G

