10
G.G.-.B.PB.B.-.-.-.-
G.G.-.B.PB.B.-.-.G.-
-.B.-.B.BP.B.-.-.-.-
B.P.B.-.B.-.-.-.-.-
P.B.-.-.-.-.-.-.-.-
B.-.-.-.-.-.B.-.-.-
-.-.S.-.-.B.P.B.-.-
-.S.W.S.-.-.B.G.B.-
-.-.S.-.-.-.-.B.P.B
A.-.-.-.-.-.-.-.B.-
